1111111111111111111111111111111111111111111111
10000000000000000000000000000000000000000000P1
1000000000000000000011111111111110000000000001
10000000000000000000100000000C1110000000000001
1000000000000000000000000000000000000000000001
1000000C00000000000001111111111111111111111111
1111111111100000000000000000000000000000000001
10000E0000100000000000000000000000000000000001
1111111111111111111111111111111111111111111111
