1111111111111111111111111111111
1000E10000000000000000000000001
1111110000000000000C00000000001
1000C10000000000000000000000001
1111110000000000000000000000001
1000000000000000000000000000001
100000000000000000000P000000001
1111111111111111111111111111111
