11111111111111
00011111111101
10000000000001
11111111111111
