11111111111111111111
1000C00000000000E001
10000000001110000011
10000000001110000111
1000000C001110000111
111000000011100C0011
11100011100000000001
1100000000P111000001
11111111111111111111
