11111111111111111111
10000000000000000001
10000000001110000011
10000000001110000111
10000000001110000111
11100000001110000011
11100011100000000001
11000000000111000001
11111111111111111111
