1111111111111111111
1111111111111111E11
1111111111111111011
1111111111111111011
1000000000000000011
1011111111111111111
10000C1111111111111
1011111111111111111
1011111111111111111
1000000000000000C11
1111111110111111111
1111111110111111111
111C000000111111111
1111011111111111111
1111P11111111111111
1111111111111111111
