111111111
1E0000001
1111111P1
1C0000001
111111111
