111111111111111111111
10000000E000001111101
1111111000C0001111101
1111000001111100000C1
10000C011111111100001
11100000000P000000001
111111111111111111111
