111111111111
1000000000E1
100001111111
1C00000000C1
100000111111
1000000000P1
111111111111
