111111111
100000EC1
1111111P1
100000011
111111111
