1111111111111
100E0000000C1
1111111001111
11000C1001111
10000000000P1
1111111111111
