111111111111
100000E00001
100000C00001
1P0000000001
1111100P0001
111111111111
