111111111111
10000000001
10000000C01
1000P0000E1
11111111111
